9555539553
AD5396C53A
AFBC6FFFAA
AFC5157FAE
AFFFAFFFC3
AD3FAFD512
C52FAFFFAA
D3C545556A
9695391796
C547C6C547

1,1
8,8

